11111
1C111
1P111
10001
1E111
11111